WWWWWWWWWWWWWWWWWWWWWWWWWWWWWWWWWWWWWWWWWWWWWWWWW
W                   WWWWWWWWW                   W
W WWWWW WWWWWWWWWWW WWWWWWWWW WWWWWWWWWWW WWWWW W
W WWWWW WWWWWWWWWWW WWWWWWWWW WWWWWWWWWWW WWWWW W
W WWWWW WWWWWWWWWWW WWWWWWWWW WWWWWWWWWWW WWWWW W
W                                               W
W WWWWW WW WWWWWWWWWWWWWWWWWWWWWWWWWWWWWW WWWWW W
W WWWWW WW                                WWWWW W
W WWWWW WW WWWWWWWWWWWWWWWWWWWWWWWWWWWWWW WWWWW W
W       WW                                      W
WWWWWWW WWWWWWWWWWWWWW WWW WWWWWWWWWWWWWW WWWWW W
W       WWWWWWWWWWWWWW WWW WWWWWWWWWWWWWW WWWWW W
W                                               W
W WWWWWWWWWWWWWWWWWWWW WWW WWWWWWWWWWWWWW WWWWW W
W WWWWWWWWWWWWWWWWWWWW WWW WWWWWWWWWWWWWW WWWWW W
W                                               W
WWWWWWWWWWW WWWWWWWWWW WWW WWWWWWWWWWWWWW WWWWW W
WWWWWWWWWWW WWWWWWWWWW WWW WWWWWWWWWWWWWW WWWWW W
WWWWWWWWWWW                                     W
W           WWWWWWWWWW WWWWWWWWWWWW WWWWW WWWWW W
W WWWWWWWWWWWWWWWWWWWW WWWWWWWWWWWW             W
W                                   WWWWW WWWWW W
W WWWWWWWWWWWWWWWWWWWW WWWWWWWWWWWW WWWWW WWWWW W
W                                     WWW WWWWW W
W WWWWWWWWWWWWWWWWWWWW WWWWWWWWWWWWWW WWW       W
W WWWWWWWWWWWWWWWWWWWW WWWWWWWWWWWWWW WWW WWWWW W
W                           WWWWWWWWW WWW       W
W WWWWWWWWWWWWWWWWWWWWWWWWW WWW       WWW WWWWW W
W WW                             WWW  WWW WWWWW W
W WW WWWWWWWWWWWWWWWWWWWWWW WWW  WWW      WWWWW W
W WW WWWWWWWWWWWWWWWWWWWWWW      WWW  WWW WWWWW W
W                           WWW                 W
WWWWWWWWWWWWWWWWWWWWWWWWWWWWWWWWWWWWWWWWWWWWWWWWW