WWWWWWWWWWWWWWWWWWWWWWWWW
W          WW           W
W WWW WWWW WW WWWW WWWW W
W                       W
W WWW WW WWWWWW WW WWWW W
W     WW WWWWWW WW      W
WWWWW WW   WW   WW WWWW W
WWWWW WWWW WW WWWW WWWW W
W                       W
W WWW W WWWWWWWW W WWW WW
W WWW W WWWWWWWW W WWW WW
W       WWWWWWWW       WW
W WWW W          WWWWW WW
W  WW W WWW WWWW W     WW
WW      WWW        WWWWWW
WWWWWWWWWWWWWWWWWWWWWWWWW